11111111111111111111111111111111111111111111111111
10001000000000000000011110000000000010010000000001
10001000000000000000011110000000000010010000000001
10011000001111101111011110000000000010010000000001
10000000001000101001010000000000000010010000010001
10000001111000000000010000000000000010000010010001
10000001000000000000010000110110000010000011000001
10011111000000000000000001000001000000000001000001
10000000000100000100010001000001000000000001000001
10000000000100000100010000001000000010010011111001
11110011111111111100010001000001000010010000000001
10000000000100000110010001000001000010010011101001
10000000000100000000010000110110000010110011101001
11110011100000000000010000000000000010100000001001
10010001000100001100010000000000000010100000001001
10010000000100010000010000000000000010100000111001
10011110011101111000011111001111111110100000100001
10111000000000010000000000000000000010100011100001
10000000000000000000001001000000000010100010000001
10000001111110011011011001110111111000100000000001
10100010000000000000000001000000010011100000000001
10110100001100000000000000000000000010101111111101
10010100100110011100111001000000010010100000000001
10000000000010000000001001010000110010100000000001
10000100000010010010001000111011110010111111011101
10000100100110000000001000000000000000100010001101
10011100001100100001001111111111111110000010001101
10000110000000110011000000000000000000100000001101
11100101111110011110000100000000000000111000011101
10000100000000000000001000011110111110100000111101
10011100000000000000110000010000000100100000111101
10000100111001101100110000010000000101100000111101
11100100101001000100110000010111010100000000111001
10000100101001000100001000110000000000111100111001
10011100000001101100000100000100000000000000001011
10000000000001000100000000101000000000111110001001
11111111001111000110001111001011010110010000001001
10000000000010000100000001000110000111000000001101
10101011110000001101010101100000000110000010001001
10110000000100100000000000010000001110010111001001
10101000110000100001010101001101110100000010001101
10000010001000100000000001000000000000000000001001
10101010001000001101010101010101010111111111101011
10110010001111000100000001000000000000000010000011
10101011010000000101010101010101010110001000000011
10000000000000000100000000000000000010100000000011
10101000000000100101010101010101010010110010000011
10110000110010000100000001000000000010110010000011
10101000000000000001010101010101010010000000000011
11111111111111111111111111111111111111111111111111
